###########
#         #
#     #   #
#  ##     #
#  $ $### #
#   @   ..#
###########